R 2160 760
NO textures/bluestone.xpm
SO textures/wall_2.xpm
WE textures/wall_3.xpm
EA textures/wall_4.xpm
S textures/sprite_1.xpm
F 32,32,32
C 0,0,153

1111111111111111111111111
1 S 1   1           1 1 1
1   1 1 1 1111111 1 1 1 1
1   1 1 1       1 1 1 1 1
1   1 1 1       1 1 1 1 1
1   1 1 1       1 1 1 1 1
1   1 1 1       1 1 1 1 1
12  111 111111111 1 1 1 1
1       1       1 1   1 1
1       1 11111 1 11111 1
1       1     1 1 1   1 1
1       111 1 1 1 1 1 1 1
1       1   1 1 1 1 1 1 1
11111 1111111 1 1 111 1 1
1       1     1 1   1 1 1
1111111 1 11111 111 1   1
1     1     1     1 1 1 1
1   1 11111 111 1 1 1 1 1
1   1     1 1   1   1 1 1
1   11111 1 1 111 111 1 1
1   1   1 1 1   1 1   1 1
1   1 1 1 11111 1 1 1 1 1
1     1 1       1   1 1 1
1111111111111111111111111