R 1000 800
NO textures/bluestone.xpm
SO textures/wall_2.xpm
WE textures/wall_3.xpm
EA textures/wall_4.xpm

S textures/sprite_1.xpm
F 32,32,32
C 0,0,153

11111111111111111111111111111
10000000000000000000000000001
10000000001000000000001000001
100020202020000000120E2100001
10001000000100000000001000001
10000000000000000000000000001
11111111111111111111111111111
